//MAP CONVERTED BY dmm2tgm.py THIS HEADER COMMENT PREVENTS RECONVERSION, DO NOT REMOVE
"a" = (
/turf/closed/wall/mineral/titanium,
/area/shuttle/arrival)
"h" = (
/turf/closed/wall/mineral/plastitanium,
/area/shuttle/arrival)
"l" = (
/obj/effect/turf_decal/stripes/line{
	dir = 8
	},
/obj/effect/turf_decal/stripes/line{
	dir = 4
	},
/obj/machinery/door/airlock/shuttle/glass,
/obj/effect/mapping_helpers/airlock/autoname,
/turf/open/floor/plating,
/area/shuttle/arrival)
"m" = (
/obj/structure/closet/firecloset/full,
/obj/effect/turf_decal/monke/siding/white{
	dir = 6
	},
/turf/open/floor/mineral/titanium/white,
/area/shuttle/arrival)
"n" = (
/obj/effect/spawner/structure/window/shuttle,
/turf/open/floor/plating,
/area/shuttle/arrival)
"u" = (
/obj/effect/turf_decal/monke/siding/white{
	dir = 4
	},
/turf/open/floor/mineral/titanium/white,
/area/shuttle/arrival)
"x" = (
/obj/structure/shuttle/engine/propulsion,
/obj/structure/window/reinforced/survival_pod{
	dir = 1
	},
/turf/open/floor/plating,
/area/shuttle/arrival)
"y" = (
/obj/structure/chair/comfy/shuttle{
	dir = 4
	},
/obj/effect/turf_decal/monke/siding/white{
	dir = 8
	},
/turf/open/floor/mineral/titanium/white,
/area/shuttle/arrival)
"z" = (
/obj/docking_port/mobile/arrivals{
	port_direction = 4;
	height = 5
	},
/turf/closed/wall/mineral/titanium,
/area/shuttle/arrival)
"B" = (
/obj/effect/turf_decal/monke/siding/white{
	dir = 1
	},
/turf/open/floor/mineral/titanium,
/area/shuttle/arrival)
"D" = (
/obj/structure/closet/emcloset/anchored,
/obj/effect/turf_decal/monke/siding/white{
	dir = 5
	},
/turf/open/floor/mineral/titanium/white,
/area/shuttle/arrival)
"L" = (
/obj/effect/turf_decal/monke/siding/white,
/turf/open/floor/mineral/titanium,
/area/shuttle/arrival)
"P" = (
/obj/structure/chair/comfy/shuttle{
	dir = 4
	},
/obj/effect/turf_decal/monke/siding/white{
	dir = 10
	},
/turf/open/floor/mineral/titanium/white,
/area/shuttle/arrival)
"Q" = (
/turf/open/floor/mineral/titanium/blue,
/area/shuttle/arrival)
"T" = (
/obj/effect/turf_decal/monke/siding/white{
	dir = 8
	},
/turf/open/floor/mineral/titanium/white,
/area/shuttle/arrival)
"X" = (
/obj/structure/chair/comfy/shuttle{
	dir = 4
	},
/obj/effect/turf_decal/monke/siding/white{
	dir = 9
	},
/turf/open/floor/mineral/titanium/white,
/area/shuttle/arrival)

(1,1,1) = {"
a
a
n
n
n
h
h
"}
(2,1,1) = {"
a
X
y
T
y
P
h
"}
(3,1,1) = {"
n
B
Q
Q
Q
L
x
"}
(4,1,1) = {"
a
D
u
u
u
m
h
"}
(5,1,1) = {"
a
a
l
z
l
h
h
"}
