//MAP CONVERTED BY dmm2tgm.py THIS HEADER COMMENT PREVENTS RECONVERSION, DO NOT REMOVE
"a" = (
/turf/closed/wall/mineral/plastitanium,
/area/template_noop)
"b" = (
/obj/machinery/suit_storage_unit/open,
/obj/effect/turf_decal/stripes/line,
/turf/open/floor/plasteel,
/area/template_noop)
"c" = (
/obj/machinery/atmospherics/pipe/manifold/purple/visible{
	dir = 1
	},
/turf/open/floor/plating,
/area/template_noop)
"d" = (
/obj/effect/turf_decal/stripes/line,
/turf/open/floor/plasteel,
/area/template_noop)
"e" = (
/obj/machinery/computer/crew,
/turf/open/floor/plasteel,
/area/template_noop)
"f" = (
/obj/machinery/atmospherics/pipe/manifold/purple/visible{
	dir = 4
	},
/turf/open/floor/plating,
/area/template_noop)
"g" = (
/obj/machinery/computer/rdconsole,
/turf/open/floor/plasteel,
/area/template_noop)
"h" = (
/obj/machinery/telecomms/receiver/preset_exploration,
/obj/effect/turf_decal/monke/siding/green{
	dir = 4
	},
/turf/open/floor/circuit/green/telecomms,
/area/template_noop)
"j" = (
/turf/closed/wall/mineral/plastitanium/nodiagonal,
/area/template_noop)
"k" = (
/obj/machinery/door/poddoor{
	id = "exploration_blastdoor"
	},
/obj/structure/fans/tiny,
/obj/effect/turf_decal/stripes/line{
	dir = 8
	},
/obj/effect/turf_decal/stripes/line{
	dir = 4
	},
/turf/open/floor/plating,
/area/template_noop)
"m" = (
/obj/structure/closet/crate,
/obj/item/pickaxe/emergency,
/obj/item/pickaxe/emergency,
/obj/item/wrench,
/obj/item/mining_scanner,
/obj/item/radio/headset/headset_exploration,
/obj/item/radio/headset/headset_exploration,
/obj/effect/turf_decal/bot,
/turf/open/floor/plasteel/techmaint,
/area/template_noop)
"n" = (
/obj/machinery/door/airlock/external,
/obj/effect/mapping_helpers/airlock/cyclelink_helper{
	dir = 4
	},
/obj/effect/turf_decal/stripes/line{
	dir = 8
	},
/turf/open/floor/plating,
/area/template_noop)
"o" = (
/turf/open/floor/plasteel,
/area/template_noop)
"p" = (
/obj/machinery/telecomms/broadcaster/preset_exploration,
/obj/effect/turf_decal/monke/siding/green{
	dir = 4
	},
/turf/open/floor/circuit/green/telecomms,
/area/template_noop)
"q" = (
/obj/machinery/door/window/survival_pod{
	dir = 8
	},
/turf/open/floor/plasteel/dark/side{
	dir = 9
	},
/area/template_noop)
"r" = (
/obj/effect/spawner/structure/window/shuttle,
/turf/open/floor/plating,
/area/template_noop)
"s" = (
/obj/machinery/atmospherics/pipe/manifold/purple/visible{
	dir = 8
	},
/turf/open/floor/plating,
/area/template_noop)
"t" = (
/obj/machinery/telecomms/hub/preset/exploration,
/obj/effect/turf_decal/monke/siding/green{
	dir = 10
	},
/turf/open/floor/circuit/green/telecomms,
/area/template_noop)
"u" = (
/obj/machinery/shuttle/engine/plasma{
	dir = 1
	},
/turf/open/floor/plating/airless,
/area/template_noop)
"v" = (
/turf/open/floor/plasteel/dark/telecomms,
/area/template_noop)
"w" = (
/obj/structure/window/reinforced/survival_pod,
/obj/structure/rack,
/obj/item/storage/toolbox/mechanical,
/obj/item/multitool,
/turf/open/floor/plasteel/dark/telecomms,
/area/template_noop)
"x" = (
/obj/item/storage/toolbox/electrical{
	pixel_x = 5;
	pixel_y = 8
	},
/obj/structure/closet/crate/science,
/obj/item/storage/toolbox/mechanical,
/obj/item/stack/sheet/mineral/plasma/twenty,
/obj/item/multitool,
/obj/item/gps/mining,
/obj/item/circuitboard/computer/shuttle/exploration_shuttle,
/obj/item/stack/sheet/mineral/plasma/fifty,
/obj/item/electronics/apc,
/obj/item/wallframe/apc,
/obj/item/stock_parts/cell/high,
/obj/effect/turf_decal/tile/yellow{
	dir = 4
	},
/obj/effect/turf_decal/tile/brown{
	dir = 1
	},
/turf/open/floor/plasteel/techmaint,
/area/template_noop)
"y" = (
/turf/closed/wall/mineral/titanium/nodiagonal,
/area/template_noop)
"z" = (
/turf/open/floor/plating,
/area/template_noop)
"A" = (
/obj/machinery/atmospherics/pipe/simple/purple/visible{
	dir = 4
	},
/turf/open/floor/plating,
/area/template_noop)
"D" = (
/obj/effect/turf_decal/tile/brown{
	dir = 1
	},
/obj/effect/turf_decal/tile/yellow{
	dir = 4
	},
/obj/structure/janitorialcart{
	dir = 8
	},
/obj/item/mop,
/obj/item/reagent_containers/glass/bucket,
/obj/item/reagent_containers/spray/cleaner,
/turf/open/floor/plasteel/techmaint,
/area/template_noop)
"E" = (
/obj/machinery/atmospherics/pipe/simple/purple/visible{
	dir = 6
	},
/turf/open/floor/plating,
/area/template_noop)
"F" = (
/obj/machinery/atmospherics/components/unary/shuttle/heater{
	dir = 1
	},
/obj/structure/window/reinforced/survival_pod{
	dir = 1
	},
/turf/open/floor/plating/airless,
/area/template_noop)
"G" = (
/obj/machinery/atmospherics/components/unary/portables_connector{
	dir = 4
	},
/obj/machinery/portable_atmospherics/canister/toxins,
/turf/open/floor/plating,
/area/template_noop)
"H" = (
/obj/machinery/telecomms/bus/preset_exploration,
/obj/effect/turf_decal/monke/siding/green{
	dir = 4
	},
/turf/open/floor/circuit/green/telecomms,
/area/template_noop)
"I" = (
/obj/structure/closet/crate,
/turf/open/floor/plasteel/dark/telecomms,
/area/template_noop)
"J" = (
/obj/machinery/door/airlock/shuttle,
/obj/effect/turf_decal/monke/siding/thinplating{
	dir = 8
	},
/turf/open/floor/plasteel/techmaint,
/area/template_noop)
"K" = (
/obj/structure/tank_dispenser,
/turf/open/floor/plating,
/area/template_noop)
"L" = (
/turf/open/floor/plasteel/techmaint,
/area/template_noop)
"M" = (
/turf/closed/wall/mineral/titanium,
/area/template_noop)
"N" = (
/obj/machinery/atmospherics/components/unary/plasma_refiner{
	dir = 8
	},
/turf/open/floor/plating,
/area/template_noop)
"P" = (
/turf/template_noop,
/area/template_noop)
"Q" = (
/obj/machinery/computer/station_alert,
/turf/open/floor/plasteel,
/area/template_noop)
"R" = (
/obj/machinery/computer/shuttle_flight/custom_shuttle/exploration,
/turf/open/floor/plasteel,
/area/template_noop)
"S" = (
/obj/machinery/door/airlock/external,
/obj/effect/mapping_helpers/airlock/cyclelink_helper{
	dir = 8
	},
/obj/effect/turf_decal/stripes/line{
	dir = 4
	},
/turf/open/floor/plating,
/area/template_noop)
"T" = (
/obj/machinery/door/airlock/shuttle,
/turf/open/floor/plasteel,
/area/template_noop)
"U" = (
/obj/machinery/telecomms/processor/preset_exploration,
/obj/effect/turf_decal/monke/siding/green{
	dir = 4
	},
/turf/open/floor/circuit/green/telecomms,
/area/template_noop)
"V" = (
/obj/machinery/computer/objective,
/turf/open/floor/plasteel,
/area/template_noop)
"W" = (
/obj/machinery/atmospherics/pipe/simple/purple/visible{
	dir = 10
	},
/turf/open/floor/plating,
/area/template_noop)
"X" = (
/obj/machinery/suit_storage_unit/exploration,
/obj/effect/turf_decal/stripes/line,
/turf/open/floor/plasteel,
/area/template_noop)
"Y" = (
/obj/machinery/telecomms/server/presets/exploration,
/obj/effect/turf_decal/monke/siding/green{
	dir = 8
	},
/turf/open/floor/circuit/green/telecomms,
/area/template_noop)
"Z" = (
/obj/machinery/button/door{
	id = "exploration_blastdoor";
	name = "Exploration Blast Door Button";
	pixel_x = 24
	},
/obj/effect/turf_decal/tile/brown{
	dir = 1
	},
/obj/effect/turf_decal/tile/yellow{
	dir = 4
	},
/obj/machinery/portable_atmospherics/canister/toxins,
/turf/open/floor/plasteel/techmaint,
/area/template_noop)

(1,1,1) = {"
P
P
P
P
M
y
y
y
y
M
P
P
P
P
P
P
"}
(2,1,1) = {"
P
P
r
y
y
p
U
H
h
y
y
n
y
n
a
P
"}
(3,1,1) = {"
P
r
r
o
y
v
v
v
v
I
y
z
y
z
j
a
"}
(4,1,1) = {"
r
r
o
o
y
Y
t
w
q
y
y
S
y
S
j
j
"}
(5,1,1) = {"
r
Q
o
o
y
y
y
y
T
y
X
z
E
s
F
u
"}
(6,1,1) = {"
r
V
o
o
o
o
o
y
o
y
X
z
N
c
F
u
"}
(7,1,1) = {"
r
R
o
o
o
o
o
T
o
T
d
z
K
A
j
j
"}
(8,1,1) = {"
r
g
o
o
o
o
o
y
o
y
b
z
G
c
F
u
"}
(9,1,1) = {"
r
e
o
o
y
y
y
y
J
y
X
z
W
f
F
u
"}
(10,1,1) = {"
r
r
o
o
y
D
L
L
L
y
y
n
y
n
j
j
"}
(11,1,1) = {"
P
r
r
o
y
x
L
L
L
m
y
z
y
z
j
a
"}
(12,1,1) = {"
P
P
r
y
y
Z
L
L
L
y
y
S
y
S
a
P
"}
(13,1,1) = {"
P
P
P
P
M
y
k
k
y
M
P
P
P
P
P
P
"}
