//MAP CONVERTED BY dmm2tgm.py THIS HEADER COMMENT PREVENTS RECONVERSION, DO NOT REMOVE
"a" = (
/obj/structure/shuttle/engine/propulsion/burst,
/turf/closed/wall/mineral/titanium/survival,
/area/shuttle/mining)
"b" = (
/obj/docking_port/mobile{
	dwidth = 1;
	height = 4;
	id = "mining";
	name = "mining shuttle";
	port_direction = 2;
	width = 3
	},
/obj/machinery/door/airlock/survival_pod/glass,
/turf/open/floor/pod,
/area/shuttle/mining)
"l" = (
/obj/structure/window/reinforced/survival_pod{
	dir = 8
	},
/obj/structure/closet/crate,
/turf/open/floor/pod,
/area/shuttle/mining)
"t" = (
/obj/structure/window/reinforced/survival_pod{
	dir = 4
	},
/obj/machinery/light/small,
/obj/structure/ore_box,
/turf/open/floor/pod,
/area/shuttle/mining)
"u" = (
/obj/structure/window/reinforced/survival_pod{
	dir = 4
	},
/obj/structure/chair/comfy/shuttle{
	dir = 8
	},
/turf/open/floor/pod,
/area/shuttle/mining)
"N" = (
/turf/open/floor/pod,
/area/shuttle/mining)
"P" = (
/obj/structure/window/reinforced/survival_pod{
	dir = 8
	},
/obj/structure/chair/comfy/shuttle{
	dir = 4
	},
/turf/open/floor/pod,
/area/shuttle/mining)
"T" = (
/obj/structure/window/reinforced/survival_pod{
	dir = 4
	},
/obj/structure/window/reinforced/survival_pod{
	dir = 1
	},
/obj/structure/window/reinforced/survival_pod{
	dir = 5
	},
/obj/structure/chair/comfy/shuttle{
	dir = 8
	},
/turf/open/floor/pod,
/area/shuttle/mining)
"W" = (
/obj/structure/window/reinforced/survival_pod{
	dir = 8
	},
/obj/structure/window/reinforced/survival_pod{
	dir = 1
	},
/obj/structure/window/reinforced/survival_pod{
	dir = 9
	},
/obj/structure/chair/comfy/shuttle{
	dir = 4
	},
/turf/open/floor/pod,
/area/shuttle/mining)
"Y" = (
/obj/structure/window/reinforced/survival_pod{
	dir = 1
	},
/obj/machinery/computer/shuttle_flight/mining,
/turf/open/floor/pod,
/area/shuttle/mining)

(1,1,1) = {"
W
P
l
a
"}
(2,1,1) = {"
Y
N
N
b
"}
(3,1,1) = {"
T
u
t
a
"}
