//MAP CONVERTED BY dmm2tgm.py THIS HEADER COMMENT PREVENTS RECONVERSION, DO NOT REMOVE
"aj" = (
/obj/structure/window/reinforced/spawner/north,
/obj/structure/window/reinforced/spawner/north{
	dir = 2
	},
/obj/structure/window/reinforced/spawner/west,
/turf/open/floor/fakespace,
/area/space)
"aG" = (
/obj/machinery/door/window/southright,
/turf/open/floor/fakespace,
/area/space)
"aV" = (
/obj/machinery/computer/station_alert{
	dir = 4
	},
/turf/open/floor/fakespace,
/area/space)
"aX" = (
/obj/machinery/suit_storage_unit/standard_unit,
/turf/open/floor/fakespace,
/area/space)
"ba" = (
/obj/machinery/door/window/southleft,
/turf/open/floor/fakespace,
/area/space)
"bk" = (
/obj/structure/window/reinforced/spawner/north,
/obj/structure/window/reinforced/spawner/east{
	dir = 8
	},
/obj/structure/chair/comfy/shuttle{
	dir = 4
	},
/turf/open/floor/fakespace,
/area/space)
"bn" = (
/obj/structure/table,
/obj/item/storage/box/donkpockets/donkpocketpizza,
/turf/open/floor/fakespace,
/area/space)
"cd" = (
/obj/structure/window/reinforced/spawner/north{
	dir = 2
	},
/obj/machinery/portable_atmospherics/canister/oxygen,
/turf/open/floor/fakespace,
/area/space)
"ce" = (
/obj/item/clothing/suit/hazardvest{
	desc = "A high-visibility lifejacket complete with whistle and slot for oxygen tanks.";
	name = "emergency lifejacket"
	},
/obj/item/clothing/suit/hazardvest{
	desc = "A high-visibility lifejacket complete with whistle and slot for oxygen tanks.";
	name = "emergency lifejacket"
	},
/obj/item/clothing/suit/hazardvest{
	desc = "A high-visibility lifejacket complete with whistle and slot for oxygen tanks.";
	name = "emergency lifejacket"
	},
/obj/item/clothing/suit/hazardvest{
	desc = "A high-visibility lifejacket complete with whistle and slot for oxygen tanks.";
	name = "emergency lifejacket"
	},
/obj/item/clothing/suit/hazardvest{
	desc = "A high-visibility lifejacket complete with whistle and slot for oxygen tanks.";
	name = "emergency lifejacket"
	},
/obj/item/tank/internals/emergency_oxygen{
	pixel_x = 3
	},
/obj/item/tank/internals/emergency_oxygen{
	pixel_x = 3
	},
/obj/item/tank/internals/emergency_oxygen{
	pixel_x = 3
	},
/obj/item/tank/internals/emergency_oxygen{
	pixel_x = 3
	},
/obj/item/tank/internals/emergency_oxygen{
	pixel_x = 3
	},
/obj/item/clothing/mask/breath{
	pixel_x = -3;
	pixel_y = -3
	},
/obj/item/clothing/mask/breath{
	pixel_x = -3;
	pixel_y = -3
	},
/obj/item/clothing/mask/breath{
	pixel_x = -3;
	pixel_y = -3
	},
/obj/item/clothing/mask/breath{
	pixel_x = -3;
	pixel_y = -3
	},
/obj/item/clothing/mask/breath{
	pixel_x = -3;
	pixel_y = -3
	},
/obj/item/clothing/head/hardhat/orange{
	name = "protective hat";
	pixel_y = 9
	},
/obj/item/clothing/head/hardhat/orange{
	name = "protective hat";
	pixel_y = 9
	},
/obj/item/clothing/head/hardhat/orange{
	name = "protective hat";
	pixel_y = 9
	},
/obj/item/clothing/head/hardhat/orange{
	name = "protective hat";
	pixel_y = 9
	},
/obj/item/clothing/head/hardhat/orange{
	name = "protective hat";
	pixel_y = 9
	},
/obj/structure/closet/crate{
	name = "lifejackets"
	},
/obj/structure/window/reinforced/spawner/east,
/turf/open/floor/fakespace,
/area/space)
"cn" = (
/obj/structure/window/reinforced/spawner/north{
	dir = 2
	},
/obj/structure/table,
/turf/open/floor/fakespace,
/area/space)
"dV" = (
/obj/structure/window/reinforced/spawner/north{
	dir = 2
	},
/obj/structure/window/reinforced/spawner/east{
	dir = 8
	},
/obj/structure/table,
/obj/item/storage/box/donkpockets/donkpocketteriyaki,
/turf/open/floor/fakespace,
/area/space)
"eh" = (
/obj/structure/window/reinforced/spawner/north{
	dir = 2
	},
/obj/structure/window/reinforced/spawner/north,
/turf/open/floor/fakespace,
/area/space)
"gn" = (
/obj/machinery/atmospherics/components/binary/dp_vent_pump,
/turf/open/floor/fakespace,
/area/space)
"gr" = (
/obj/structure/chair/comfy/shuttle,
/turf/open/floor/fakespace,
/area/space)
"gT" = (
/obj/machinery/stasis,
/turf/open/floor/fakespace,
/area/space)
"gZ" = (
/obj/structure/window/reinforced/spawner/east{
	dir = 8
	},
/obj/structure/rack,
/obj/item/storage/toolbox/emergency{
	pixel_x = 3;
	pixel_y = -5
	},
/obj/item/storage/toolbox/mechanical{
	pixel_y = -1
	},
/obj/item/storage/toolbox/electrical{
	pixel_x = -3;
	pixel_y = 1
	},
/turf/open/floor/fakespace,
/area/space)
"hl" = (
/obj/machinery/computer/communications{
	dir = 4
	},
/turf/open/floor/fakespace,
/area/space)
"hp" = (
/obj/structure/window/reinforced/spawner/east{
	dir = 8
	},
/obj/structure/closet/crate,
/turf/open/floor/fakespace,
/area/space)
"hq" = (
/obj/structure/window/reinforced/spawner/east,
/obj/structure/window/reinforced/spawner/north{
	dir = 2
	},
/obj/structure/closet/crate,
/turf/open/floor/fakespace,
/area/space)
"hz" = (
/turf/template_noop,
/area/space)
"iG" = (
/obj/structure/table,
/obj/item/storage/fancy/donut_box,
/turf/open/floor/fakespace,
/area/space)
"iH" = (
/obj/structure/window/reinforced/spawner/east,
/obj/structure/window/reinforced/spawner/north,
/obj/machinery/recharge_station,
/turf/open/floor/fakespace,
/area/space)
"kf" = (
/obj/structure/window/reinforced/spawner/north{
	dir = 2
	},
/obj/structure/table,
/obj/item/storage/firstaid/o2{
	pixel_x = 3;
	pixel_y = 3
	},
/obj/item/storage/firstaid/toxin,
/turf/open/floor/fakespace,
/area/space)
"kZ" = (
/obj/structure/window/reinforced/spawner/north,
/obj/machinery/computer/security,
/turf/open/floor/fakespace,
/area/space)
"lD" = (
/obj/structure/shuttle/engine/propulsion{
	dir = 8
	},
/turf/open/floor/plating/airless,
/area/space)
"mH" = (
/obj/machinery/door/window/westleft{
	name = "Bridge Deliveries";
	req_access_txt = "19"
	},
/turf/open/floor/fakespace,
/area/space)
"nz" = (
/obj/structure/window/reinforced/spawner/north{
	dir = 2
	},
/obj/structure/table,
/obj/item/hand_labeler_refill,
/obj/item/pen,
/obj/item/folder/yellow,
/obj/item/clipboard,
/turf/open/floor/fakespace,
/area/space)
"nA" = (
/obj/machinery/atmospherics/pipe/simple/orange/hidden{
	dir = 4
	},
/turf/open/floor/fakespace,
/area/space)
"nG" = (
/obj/structure/window/reinforced/spawner/north{
	dir = 2
	},
/obj/structure/table,
/obj/machinery/recharger{
	active_power_usage = 0;
	idle_power_usage = 0;
	use_power = 0
	},
/turf/open/floor/fakespace,
/area/space)
"ou" = (
/obj/structure/closet/emcloset,
/turf/open/floor/fakespace,
/area/space)
"oN" = (
/obj/machinery/atmospherics/pipe/simple/orange/hidden{
	dir = 9
	},
/turf/open/floor/fakespace,
/area/space)
"pb" = (
/obj/structure/window/reinforced/spawner/north,
/obj/machinery/stasis,
/turf/open/floor/fakespace,
/area/space)
"pj" = (
/obj/structure/window/reinforced/spawner/north{
	dir = 2
	},
/obj/structure/table,
/obj/item/storage/box/donkpockets/donkpocketspicy,
/turf/open/floor/fakespace,
/area/space)
"qp" = (
/obj/structure/window/reinforced/spawner/north{
	dir = 2
	},
/obj/structure/window/reinforced/spawner/north,
/obj/structure/window/reinforced/spawner/west,
/turf/open/floor/fakespace,
/area/space)
"qw" = (
/turf/open/floor/fakespace,
/area/space)
"qN" = (
/obj/machinery/atmospherics/components/unary/tank/air,
/turf/open/floor/fakespace,
/area/space)
"qY" = (
/obj/machinery/door/window/westleft,
/turf/open/floor/fakespace,
/area/space)
"rv" = (
/obj/machinery/computer/warrant{
	dir = 4
	},
/turf/open/floor/fakespace,
/area/space)
"rF" = (
/obj/structure/table,
/obj/item/folder/blue,
/turf/open/floor/fakespace,
/area/space)
"tB" = (
/obj/structure/tank_dispenser/oxygen{
	layer = 2.7;
	pixel_x = -1;
	pixel_y = 2
	},
/obj/structure/window/reinforced/spawner/east,
/turf/open/floor/fakespace,
/area/space)
"uV" = (
/obj/machinery/door/window/northleft{
	name = "Reception Window"
	},
/turf/open/floor/fakespace,
/area/space)
"vQ" = (
/obj/structure/window/reinforced/spawner/north{
	dir = 2
	},
/obj/structure/rack,
/obj/item/clothing/head/hardhat/red,
/obj/item/clothing/mask/gas,
/obj/item/clothing/suit/fire/firefighter,
/obj/item/tank/internals/oxygen/red,
/turf/open/floor/fakespace,
/area/space)
"wa" = (
/obj/structure/window/reinforced/spawner/north{
	dir = 2
	},
/obj/structure/table,
/obj/item/restraints/handcuffs{
	pixel_y = 3
	},
/turf/open/floor/fakespace,
/area/space)
"wz" = (
/obj/structure/table,
/obj/item/stack/medical/gauze,
/obj/item/stack/medical/bruise_pack,
/obj/item/stack/medical/ointment,
/turf/open/floor/fakespace,
/area/space)
"wD" = (
/obj/structure/window/reinforced/spawner/east{
	dir = 8
	},
/obj/structure/rack,
/obj/item/stack/cable_coil,
/obj/item/wirecutters,
/obj/item/weldingtool,
/obj/item/wrench,
/obj/item/crowbar,
/turf/open/floor/fakespace,
/area/space)
"wH" = (
/obj/structure/chair/office,
/turf/open/floor/fakespace,
/area/space)
"wJ" = (
/obj/structure/chair/office{
	dir = 1
	},
/turf/open/floor/fakespace,
/area/space)
"xS" = (
/obj/structure/window/reinforced/spawner/north,
/turf/open/floor/fakespace,
/area/space)
"xU" = (
/obj/machinery/door/window/westleft{
	dir = 1;
	name = "Bridge Deliveries";
	req_access_txt = "19"
	},
/turf/open/floor/fakespace,
/area/space)
"yk" = (
/obj/machinery/atmospherics/pipe/simple/orange/hidden,
/obj/machinery/advanced_airlock_controller{
	pixel_y = 24
	},
/turf/open/floor/fakespace,
/area/space)
"yr" = (
/obj/machinery/atmospherics/pipe/simple/orange/hidden{
	dir = 10
	},
/obj/structure/window/reinforced/spawner/north,
/turf/open/floor/fakespace,
/area/space)
"yL" = (
/obj/structure/window/reinforced/spawner/north{
	dir = 2
	},
/obj/structure/closet/crate{
	name = "emergency supplies crate"
	},
/obj/item/radio,
/obj/item/wrench,
/obj/item/crowbar,
/obj/item/flashlight/flare{
	pixel_x = -6;
	pixel_y = -2
	},
/obj/item/flashlight/flare{
	pixel_x = 3;
	pixel_y = 3
	},
/obj/item/storage/toolbox/emergency,
/turf/open/floor/fakespace,
/area/space)
"zv" = (
/obj/structure/table,
/obj/item/paper_bin{
	pixel_x = -2;
	pixel_y = 8
	},
/turf/open/floor/fakespace,
/area/space)
"Ae" = (
/obj/structure/window/reinforced/spawner/north,
/obj/structure/reagent_dispensers/fueltank,
/turf/open/floor/fakespace,
/area/space)
"An" = (
/obj/structure/window/reinforced/spawner/north{
	dir = 2
	},
/obj/structure/window/reinforced/spawner/east{
	dir = 8
	},
/obj/structure/table,
/obj/item/book/manual/wiki/security_space_law{
	pixel_x = -4;
	pixel_y = 4
	},
/obj/item/folder/red{
	pixel_x = 3
	},
/turf/open/floor/fakespace,
/area/space)
"BF" = (
/obj/structure/window/reinforced/spawner/east,
/obj/structure/closet/crate,
/turf/open/floor/fakespace,
/area/space)
"BU" = (
/obj/structure/window/reinforced/spawner/north{
	dir = 2
	},
/obj/structure/sink,
/turf/open/floor/fakespace,
/area/space)
"CI" = (
/obj/structure/window/reinforced/spawner/north{
	dir = 2
	},
/obj/structure/window/reinforced/spawner/east{
	dir = 8
	},
/turf/open/floor/fakespace,
/area/space)
"CX" = (
/obj/structure/window/reinforced/spawner/east{
	dir = 8
	},
/obj/structure/chair/comfy/shuttle{
	dir = 4
	},
/turf/open/floor/fakespace,
/area/space)
"Dj" = (
/obj/structure/table,
/obj/item/storage/toolbox/emergency{
	pixel_y = 3
	},
/turf/open/floor/fakespace,
/area/space)
"Eh" = (
/obj/machinery/holopad,
/turf/open/floor/fakespace,
/area/space)
"El" = (
/obj/structure/window/reinforced/spawner/north{
	dir = 2
	},
/obj/structure/table,
/obj/item/storage/firstaid/regular{
	pixel_x = 2;
	pixel_y = 3
	},
/obj/item/storage/firstaid/fire,
/turf/open/floor/fakespace,
/area/space)
"EW" = (
/obj/structure/window/reinforced/spawner/north,
/obj/structure/reagent_dispensers/foamtank,
/turf/open/floor/fakespace,
/area/space)
"Fz" = (
/obj/structure/window/reinforced/spawner/north{
	dir = 2
	},
/turf/open/floor/fakespace,
/area/space)
"Gb" = (
/obj/structure/window/reinforced/spawner/north,
/obj/structure/window/reinforced/spawner/east,
/turf/open/floor/fakespace,
/area/space)
"Gg" = (
/obj/structure/window/reinforced/spawner/north,
/obj/machinery/recharge_station,
/turf/open/floor/fakespace,
/area/space)
"GB" = (
/obj/structure/window/reinforced/spawner/north,
/obj/structure/reagent_dispensers/watertank,
/turf/open/floor/fakespace,
/area/space)
"ID" = (
/obj/structure/chair/office{
	dir = 8
	},
/turf/open/floor/fakespace,
/area/space)
"IZ" = (
/obj/structure/window/reinforced/spawner/north,
/obj/structure/window/reinforced/spawner/north{
	dir = 2
	},
/obj/structure/window/reinforced/spawner/east,
/turf/open/floor/fakespace,
/area/space)
"Jo" = (
/obj/structure/window/reinforced/spawner/east{
	dir = 8
	},
/obj/structure/table,
/obj/item/cautery,
/obj/item/surgicaldrill,
/obj/item/clothing/mask/surgical,
/obj/item/clothing/gloves/color/latex,
/obj/item/retractor{
	pixel_x = 4
	},
/obj/item/hemostat{
	pixel_x = -4
	},
/obj/item/scalpel{
	pixel_y = 12
	},
/obj/item/circular_saw,
/turf/open/floor/fakespace,
/area/space)
"Ka" = (
/obj/structure/window/reinforced/spawner/east{
	dir = 8
	},
/obj/structure/window/reinforced/spawner/north{
	dir = 2
	},
/obj/structure/window/reinforced/spawner/north,
/turf/open/floor/fakespace,
/area/space)
"KC" = (
/obj/structure/window/reinforced/spawner/north{
	dir = 2
	},
/obj/structure/closet/crate/medical{
	name = "medical crate"
	},
/mob/living/simple_animal/bot/medbot{
	name = "\improper emergency medibot";
	pixel_x = -3;
	pixel_y = 2
	},
/obj/item/lazarus_injector,
/obj/item/healthanalyzer{
	pixel_x = 3;
	pixel_y = 3
	},
/obj/item/storage/firstaid/toxin{
	pixel_x = -4;
	pixel_y = 3
	},
/obj/item/storage/firstaid/o2{
	pixel_x = 3;
	pixel_y = 3
	},
/obj/item/storage/firstaid/regular,
/turf/open/floor/fakespace,
/area/space)
"Lj" = (
/obj/structure/window/reinforced/spawner/north,
/obj/machinery/computer/crew,
/turf/open/floor/fakespace,
/area/space)
"Lv" = (
/obj/structure/window/reinforced/spawner/north,
/obj/structure/window/reinforced/spawner/east{
	dir = 8
	},
/obj/structure/closet/crate,
/turf/open/floor/fakespace,
/area/space)
"LA" = (
/obj/machinery/computer/emergency_shuttle{
	dir = 4
	},
/turf/open/floor/fakespace,
/area/space)
"LH" = (
/obj/machinery/door/window/northright,
/turf/open/floor/fakespace,
/area/space)
"MN" = (
/obj/structure/window/reinforced/spawner/east{
	dir = 8
	},
/turf/open/floor/fakespace,
/area/space)
"MP" = (
/obj/structure/window/reinforced/spawner/east{
	dir = 8
	},
/obj/structure/table,
/obj/item/reagent_containers/glass/bottle/epinephrine{
	pixel_x = -3;
	pixel_y = 8
	},
/obj/item/reagent_containers/glass/bottle/charcoal{
	pixel_x = 6;
	pixel_y = 8
	},
/obj/item/reagent_containers/syringe/epinephrine{
	pixel_x = 2;
	pixel_y = 8
	},
/obj/item/reagent_containers/syringe/epinephrine{
	pixel_x = -2;
	pixel_y = 5
	},
/obj/item/reagent_containers/glass/bottle/epinephrine{
	pixel_x = 6
	},
/obj/item/reagent_containers/glass/bottle/charcoal{
	pixel_x = -3
	},
/obj/item/reagent_containers/syringe/epinephrine{
	pixel_x = 4;
	pixel_y = 1
	},
/obj/item/reagent_containers/syringe/epinephrine{
	pixel_x = 3;
	pixel_y = -2
	},
/turf/open/floor/fakespace,
/area/space)
"MX" = (
/obj/structure/window/reinforced/spawner/north{
	dir = 2
	},
/obj/structure/table,
/obj/item/storage/box/handcuffs{
	pixel_x = 2;
	pixel_y = 2
	},
/turf/open/floor/fakespace,
/area/space)
"Nn" = (
/obj/machinery/door/window/eastright{
	base_state = "left";
	dir = 1;
	icon_state = "left";
	name = "Security Delivery";
	req_access_txt = "1"
	},
/turf/open/floor/fakespace,
/area/space)
"Np" = (
/obj/structure/chair/comfy/shuttle{
	dir = 8
	},
/turf/open/floor/fakespace,
/area/space)
"NE" = (
/obj/machinery/door/window/northleft{
	name = "Reception Window";
	dir = 8
	},
/turf/open/floor/fakespace,
/area/space)
"Oi" = (
/obj/structure/window/reinforced/spawner/north{
	dir = 2
	},
/obj/structure/window/reinforced/spawner/east{
	dir = 8
	},
/obj/structure/closet/crate,
/turf/open/floor/fakespace,
/area/space)
"PG" = (
/obj/machinery/atmospherics/pipe/simple/orange/hidden{
	dir = 6
	},
/turf/open/floor/fakespace,
/area/space)
"Rn" = (
/obj/structure/window/reinforced/spawner/north,
/obj/structure/chair/comfy/shuttle,
/turf/open/floor/fakespace,
/area/space)
"Rs" = (
/obj/structure/window/reinforced/spawner/north,
/obj/machinery/shower{
	pixel_y = -8
	},
/turf/open/floor/fakespace,
/area/space)
"Rw" = (
/obj/structure/chair/comfy/shuttle{
	dir = 4
	},
/turf/open/floor/fakespace,
/area/space)
"Su" = (
/obj/structure/window/reinforced/spawner/north,
/obj/structure/table,
/obj/item/storage/firstaid/regular,
/turf/open/floor/fakespace,
/area/space)
"Td" = (
/obj/structure/window/reinforced/spawner/north{
	dir = 2
	},
/obj/structure/window/reinforced/spawner/north,
/obj/structure/window/reinforced/spawner/east,
/turf/open/floor/fakespace,
/area/space)
"Tf" = (
/obj/structure/window/reinforced/spawner/north{
	dir = 2
	},
/obj/machinery/space_heater,
/turf/open/floor/fakespace,
/area/space)
"Tu" = (
/obj/structure/window/reinforced/spawner/north,
/obj/structure/window/reinforced/spawner/east{
	dir = 8
	},
/turf/open/floor/fakespace,
/area/space)
"TQ" = (
/obj/structure/window/reinforced/spawner/east,
/turf/open/floor/fakespace,
/area/space)
"TY" = (
/obj/structure/table,
/obj/machinery/recharger{
	active_power_usage = 0;
	idle_power_usage = 0;
	pixel_y = 4;
	use_power = 0
	},
/turf/open/floor/fakespace,
/area/space)
"UB" = (
/obj/structure/window/reinforced/spawner/north,
/obj/structure/window/reinforced/spawner/east{
	dir = 8
	},
/obj/structure/table,
/obj/item/defibrillator/loaded,
/turf/open/floor/fakespace,
/area/space)
"Vi" = (
/obj/structure/window/reinforced/spawner/north,
/obj/structure/closet/emcloset,
/turf/open/floor/fakespace,
/area/space)
"Vz" = (
/obj/structure/table,
/obj/item/restraints/handcuffs{
	pixel_y = 3
	},
/turf/open/floor/fakespace,
/area/space)
"VF" = (
/obj/machinery/atmospherics/pipe/manifold/orange/hidden,
/turf/open/floor/fakespace,
/area/space)
"Wj" = (
/obj/machinery/door/window/northleft{
	name = "Reception Window"
	},
/obj/structure/fans/tiny,
/turf/open/floor/fakespace,
/area/space)
"Wp" = (
/obj/structure/window/reinforced/spawner/north,
/obj/structure/window/reinforced/spawner/north{
	dir = 2
	},
/turf/open/floor/fakespace,
/area/space)
"WS" = (
/obj/structure/window/reinforced/spawner/east{
	dir = 8
	},
/obj/structure/window/reinforced/spawner/north,
/obj/structure/table,
/obj/item/phone{
	pixel_x = -3;
	pixel_y = 3
	},
/obj/item/cigbutt/cigarbutt{
	pixel_x = 5;
	pixel_y = -1
	},
/turf/open/floor/fakespace,
/area/space)
"WT" = (
/obj/structure/shuttle/engine/heater{
	dir = 8
	},
/obj/structure/window/reinforced{
	dir = 4
	},
/turf/open/floor/plating/airless,
/area/space)
"Xl" = (
/obj/structure/chair/comfy/shuttle{
	dir = 1
	},
/turf/open/floor/fakespace,
/area/space)
"Xy" = (
/obj/structure/window/reinforced/spawner/north,
/obj/structure/chair/comfy/shuttle{
	dir = 4
	},
/turf/open/floor/fakespace,
/area/space)
"YD" = (
/obj/structure/window/reinforced/spawner/east{
	dir = 8
	},
/obj/structure/table/optable,
/obj/item/surgical_drapes,
/turf/open/floor/fakespace,
/area/space)
"Zb" = (
/obj/machinery/door/window/northleft{
	name = "Reception Window"
	},
/obj/docking_port/mobile/emergency{
	dir = 2;
	dwidth = 5;
	height = 14;
	name = "Meta emergency shuttle";
	width = 25
	},
/obj/structure/fans/tiny,
/turf/open/floor/fakespace,
/area/space)

(1,1,1) = {"
hz
hz
lD
lD
lD
qw
lD
lD
qw
lD
lD
lD
hz
hz
"}
(2,1,1) = {"
hz
Ka
WT
WT
WT
TQ
WT
WT
TQ
WT
WT
WT
Ka
hz
"}
(3,1,1) = {"
WS
iG
hl
LA
aV
rv
Dj
TY
Xy
Rw
Rw
Rw
qN
CI
"}
(4,1,1) = {"
xS
qw
wH
ID
ID
wJ
qw
bn
xS
qw
qw
qw
nA
Fz
"}
(5,1,1) = {"
Lj
qw
qw
qw
qw
qw
qw
zv
xS
qw
PG
gn
VF
ba
"}
(6,1,1) = {"
kZ
wJ
qw
qw
qw
qw
wH
rF
Tu
qY
yr
yk
oN
aG
"}
(7,1,1) = {"
Su
Vz
qw
qw
qw
qw
qw
qw
xU
qw
xS
aX
aX
Fz
"}
(8,1,1) = {"
Tu
MN
MN
MN
mH
MN
MN
MN
bk
CX
CX
CX
CX
An
"}
(9,1,1) = {"
Vi
qw
Rw
Rw
Rw
Rw
qw
ou
xS
qw
qw
qw
qw
wa
"}
(10,1,1) = {"
xS
qw
qw
qw
qw
qw
qw
qw
Nn
qw
qw
qw
qw
nG
"}
(11,1,1) = {"
Rn
qw
qw
Xl
aj
gr
qw
Xl
Rn
qw
qw
qw
qw
MX
"}
(12,1,1) = {"
Wj
qw
qw
Xl
Wp
gr
qw
Xl
Rn
Np
Np
Np
Np
pj
"}
(13,1,1) = {"
Rn
qw
qw
Xl
Wp
gr
qw
Xl
UB
MP
YD
YD
Jo
dV
"}
(14,1,1) = {"
Wj
qw
qw
Xl
Wp
gr
qw
Xl
xS
qw
qw
qw
qw
cn
"}
(15,1,1) = {"
Rn
qw
qw
Xl
IZ
gr
qw
Xl
Rs
qw
qw
qw
qw
BU
"}
(16,1,1) = {"
Rn
qw
qw
qw
qw
qw
qw
qw
uV
qw
qw
qw
qw
El
"}
(17,1,1) = {"
Rn
qw
qw
Xl
qp
gr
qw
Xl
pb
gT
gT
qw
gT
kf
"}
(18,1,1) = {"
Rn
qw
qw
Xl
eh
gr
qw
Xl
Lv
wD
gZ
NE
hp
Oi
"}
(19,1,1) = {"
Rn
qw
qw
Xl
eh
gr
qw
Xl
EW
qw
qw
qw
qw
vQ
"}
(20,1,1) = {"
Zb
qw
qw
Xl
eh
gr
qw
Xl
GB
qw
qw
qw
qw
Tf
"}
(21,1,1) = {"
Rn
qw
qw
Xl
Td
gr
qw
Xl
Ae
qw
qw
qw
qw
yL
"}
(22,1,1) = {"
Wj
qw
qw
qw
qw
qw
qw
qw
uV
qw
qw
qw
qw
KC
"}
(23,1,1) = {"
Rn
qw
Np
Np
Np
Np
qw
qw
LH
qw
qw
qw
qw
cd
"}
(24,1,1) = {"
Rn
qw
qw
qw
qw
Eh
qw
wz
Gg
qw
qw
qw
qw
nz
"}
(25,1,1) = {"
Gb
ce
tB
ce
TQ
TQ
TQ
TQ
iH
BF
BF
BF
BF
hq
"}
