//MAP CONVERTED BY dmm2tgm.py THIS HEADER COMMENT PREVENTS RECONVERSION, DO NOT REMOVE
"a" = (
/turf/template_noop,
/area/template_noop)
"c" = (
/obj/structure/table/reinforced,
/obj/effect/decal/cleanable/dirt,
/turf/open/floor/pod/light,
/area/shuttle/mining/large)
"d" = (
/obj/machinery/computer/shuttle_flight/mining,
/obj/effect/turf_decal/bot_white,
/turf/open/floor/pod/light,
/area/shuttle/mining/large)
"e" = (
/obj/structure/table/reinforced,
/obj/item/clothing/mask/gas,
/obj/item/tank/internals/emergency_oxygen,
/turf/open/floor/pod/light,
/area/shuttle/mining/large)
"f" = (
/obj/structure/table/reinforced,
/obj/item/storage/firstaid/regular,
/turf/open/floor/pod/light,
/area/shuttle/mining/large)
"g" = (
/obj/effect/turf_decal/tile/neutral,
/obj/effect/turf_decal/tile/neutral{
	dir = 8
	},
/obj/effect/turf_decal/tile/neutral{
	dir = 4
	},
/obj/structure/chair/comfy/shuttle{
	dir = 1
	},
/obj/effect/turf_decal/bot_white,
/turf/open/floor/pod/light,
/area/shuttle/mining/large)
"h" = (
/obj/effect/turf_decal/tile/neutral,
/obj/effect/turf_decal/tile/neutral{
	dir = 8
	},
/obj/effect/turf_decal/tile/neutral{
	dir = 4
	},
/obj/effect/turf_decal/tile/neutral{
	dir = 1
	},
/obj/structure/chair/comfy/shuttle{
	dir = 1
	},
/obj/effect/turf_decal/bot_white,
/turf/open/floor/pod/light,
/area/shuttle/mining/large)
"i" = (
/obj/effect/turf_decal/tile/neutral,
/obj/effect/turf_decal/tile/neutral{
	dir = 8
	},
/obj/effect/turf_decal/tile/neutral{
	dir = 1
	},
/obj/structure/chair/comfy/shuttle{
	dir = 1
	},
/obj/effect/turf_decal/bot_white,
/turf/open/floor/pod/light,
/area/shuttle/mining/large)
"j" = (
/obj/structure/table/reinforced,
/obj/item/gps/mining,
/turf/open/floor/pod/light,
/area/shuttle/mining/large)
"k" = (
/turf/closed/wall/mineral/titanium/survival/nodiagonal,
/area/shuttle/mining/large)
"l" = (
/obj/structure/table/reinforced,
/obj/item/folder/yellow,
/obj/item/pen,
/obj/effect/decal/cleanable/dirt,
/obj/machinery/light/directional/south,
/turf/open/floor/pod/light,
/area/shuttle/mining/large)
"m" = (
/obj/effect/turf_decal/tile/neutral,
/obj/effect/turf_decal/tile/neutral{
	dir = 4
	},
/obj/effect/turf_decal/tile/neutral{
	dir = 1
	},
/obj/effect/turf_decal/stripes/white/corner,
/turf/open/floor/pod/light,
/area/shuttle/mining/large)
"n" = (
/obj/effect/turf_decal/tile/neutral,
/obj/effect/turf_decal/tile/neutral{
	dir = 8
	},
/obj/effect/turf_decal/tile/neutral{
	dir = 4
	},
/obj/effect/turf_decal/tile/neutral{
	dir = 1
	},
/obj/effect/turf_decal/stripes/white/line,
/turf/open/floor/pod/light,
/area/shuttle/mining/large)
"o" = (
/obj/effect/turf_decal/tile/neutral{
	dir = 8
	},
/obj/effect/turf_decal/tile/neutral{
	dir = 4
	},
/obj/effect/turf_decal/tile/neutral{
	dir = 1
	},
/obj/effect/turf_decal/stripes/white/corner{
	dir = 8
	},
/obj/item/radio/intercom{
	pixel_y = -29
	},
/obj/effect/decal/cleanable/dirt,
/turf/open/floor/pod/light,
/area/shuttle/mining/large)
"p" = (
/obj/structure/table/reinforced,
/obj/effect/decal/cleanable/dirt,
/obj/item/stock_parts/cell/high,
/obj/item/screwdriver{
	pixel_y = 18
	},
/obj/machinery/light/directional/south,
/turf/open/floor/pod/light,
/area/shuttle/mining/large)
"q" = (
/obj/machinery/status_display/evac,
/turf/closed/wall/mineral/titanium/survival/nodiagonal,
/area/shuttle/mining/large)
"r" = (
/obj/effect/turf_decal/tile/neutral,
/obj/effect/turf_decal/tile/neutral{
	dir = 8
	},
/obj/effect/turf_decal/tile/neutral{
	dir = 4
	},
/obj/effect/turf_decal/tile/neutral{
	dir = 1
	},
/obj/machinery/door/airlock/survival_pod/glass,
/turf/open/floor/pod/light,
/area/shuttle/mining/large)
"s" = (
/obj/item/clothing/suit/hazardvest{
	desc = "A high-visibility lifejacket complete with whistle and slot for oxygen tanks.";
	name = "emergency lifejacket"
	},
/obj/item/clothing/suit/hazardvest{
	desc = "A high-visibility lifejacket complete with whistle and slot for oxygen tanks.";
	name = "emergency lifejacket"
	},
/obj/item/clothing/suit/hazardvest{
	desc = "A high-visibility lifejacket complete with whistle and slot for oxygen tanks.";
	name = "emergency lifejacket"
	},
/obj/item/clothing/suit/hazardvest{
	desc = "A high-visibility lifejacket complete with whistle and slot for oxygen tanks.";
	name = "emergency lifejacket"
	},
/obj/item/clothing/suit/hazardvest{
	desc = "A high-visibility lifejacket complete with whistle and slot for oxygen tanks.";
	name = "emergency lifejacket"
	},
/obj/item/tank/internals/emergency_oxygen{
	pixel_x = 3
	},
/obj/item/tank/internals/emergency_oxygen{
	pixel_x = 3
	},
/obj/item/tank/internals/emergency_oxygen{
	pixel_x = 3
	},
/obj/item/tank/internals/emergency_oxygen{
	pixel_x = 3
	},
/obj/item/tank/internals/emergency_oxygen{
	pixel_x = 3
	},
/obj/item/clothing/mask/breath{
	pixel_x = -3;
	pixel_y = -3
	},
/obj/item/clothing/mask/breath{
	pixel_x = -3;
	pixel_y = -3
	},
/obj/item/clothing/mask/breath{
	pixel_x = -3;
	pixel_y = -3
	},
/obj/item/clothing/mask/breath{
	pixel_x = -3;
	pixel_y = -3
	},
/obj/item/clothing/mask/breath{
	pixel_x = -3;
	pixel_y = -3
	},
/obj/item/clothing/head/hardhat/orange{
	name = "protective hat";
	pixel_y = 9
	},
/obj/item/clothing/head/hardhat/orange{
	name = "protective hat";
	pixel_y = 9
	},
/obj/item/clothing/head/hardhat/orange{
	name = "protective hat";
	pixel_y = 9
	},
/obj/item/clothing/head/hardhat/orange{
	name = "protective hat";
	pixel_y = 9
	},
/obj/item/clothing/head/hardhat/orange{
	name = "protective hat";
	pixel_y = 9
	},
/obj/structure/closet/crate/internals,
/obj/item/pickaxe/emergency,
/obj/item/pickaxe/emergency,
/obj/item/gps/mining,
/obj/machinery/light/directional/north,
/turf/open/floor/pod/light,
/area/shuttle/mining/large)
"t" = (
/obj/effect/turf_decal/box/white/corners{
	dir = 8
	},
/obj/structure/ore_box,
/turf/open/floor/pod/dark,
/area/shuttle/mining/large)
"u" = (
/obj/effect/turf_decal/tile/neutral,
/obj/effect/turf_decal/tile/neutral{
	dir = 8
	},
/obj/effect/turf_decal/tile/neutral{
	dir = 4
	},
/obj/effect/turf_decal/tile/neutral{
	dir = 1
	},
/obj/effect/turf_decal/stripes/white/line{
	dir = 4
	},
/obj/machinery/button/door{
	id = s;
	name = "Mining Freight Door";
	pixel_x = 24;
	pixel_y = 24;
	req_one_access_txt = "17;19"
	},
/turf/open/floor/pod/light,
/area/shuttle/mining/large)
"v" = (
/obj/effect/turf_decal/box/white/corners{
	dir = 1
	},
/turf/open/floor/pod/dark,
/area/shuttle/mining/large)
"w" = (
/obj/effect/turf_decal/box/white/corners{
	dir = 4
	},
/obj/effect/decal/cleanable/dirt,
/obj/machinery/light/directional/north,
/turf/open/floor/pod/dark,
/area/shuttle/mining/large)
"x" = (
/obj/effect/decal/cleanable/dirt,
/turf/open/floor/pod/light,
/area/shuttle/mining/large)
"y" = (
/obj/machinery/door/airlock/external/glass{
	name = "Public Mining Shuttle"
	},
/obj/effect/mapping_helpers/airlock/cyclelink_helper{
	dir = 8
	},
/turf/open/floor/pod/light,
/area/shuttle/mining/large)
"z" = (
/obj/effect/turf_decal/tile/neutral,
/obj/effect/turf_decal/tile/neutral{
	dir = 8
	},
/obj/effect/turf_decal/tile/neutral{
	dir = 4
	},
/obj/effect/turf_decal/stripes/white/line{
	dir = 9
	},
/obj/effect/turf_decal/tile/neutral{
	dir = 1
	},
/turf/open/floor/pod/light,
/area/shuttle/mining/large)
"A" = (
/obj/machinery/door/airlock/external/glass{
	name = "Public Mining Shuttle"
	},
/obj/docking_port/mobile{
	dir = 4;
	dwidth = 3;
	height = 5;
	id = "mining";
	name = "mining shuttle";
	port_direction = 8;
	width = 7
	},
/obj/structure/fans/tiny,
/obj/effect/mapping_helpers/airlock/cyclelink_helper{
	dir = 4
	},
/turf/open/floor/plating,
/area/shuttle/mining/large)
"B" = (
/turf/open/floor/pod/dark,
/area/shuttle/mining/large)
"C" = (
/obj/effect/turf_decal/stripes/white/line{
	dir = 1
	},
/obj/structure/rack,
/obj/item/crowbar/red,
/obj/item/wrench,
/obj/item/flashlight,
/obj/machinery/power/apc/highcap{
	dir = 4;
	locked = 0;
	name = "Mining Shuttle APC";
	pixel_y = -24
	},
/obj/structure/cable/yellow,
/obj/structure/cable/yellow,
/obj/item/gps/mining,
/turf/open/floor/plating,
/area/shuttle/mining/large)
"D" = (
/obj/structure/closet/crate/internals,
/obj/item/storage/toolbox/emergency,
/turf/open/floor/pod/light,
/area/shuttle/mining/large)
"E" = (
/obj/effect/turf_decal/box/white/corners,
/obj/structure/ore_box,
/turf/open/floor/pod/dark,
/area/shuttle/mining/large)
"F" = (
/turf/closed/wall/mineral/titanium/survival,
/area/shuttle/mining/large)
"G" = (
/obj/machinery/door/poddoor/shutters{
	id = "publicmine"
	},
/obj/structure/fans/tiny,
/turf/open/floor/plating,
/area/shuttle/mining/large)
"H" = (
/obj/structure/shuttle/engine/heater,
/obj/structure/window/reinforced/survival_pod/spawner/north,
/turf/open/floor/plating,
/area/shuttle/mining/large)
"I" = (
/turf/template_noop,
/area/shuttle/mining/large)
"J" = (
/obj/structure/shuttle/engine/propulsion/burst,
/turf/template_noop,
/area/shuttle/mining/large)
"Q" = (
/obj/effect/spawner/structure/window/survival_pod,
/turf/open/floor/plating,
/area/shuttle/mining/large)

(1,1,1) = {"
a
Q
Q
k
k
Q
A
k
F
I
"}
(2,1,1) = {"
Q
Q
f
l
k
s
x
C
k
I
"}
(3,1,1) = {"
Q
c
g
m
q
Q
y
k
k
k
"}
(4,1,1) = {"
Q
d
h
n
r
u
z
D
H
J
"}
(5,1,1) = {"
Q
e
i
o
k
v
B
t
k
k
"}
(6,1,1) = {"
Q
Q
j
p
k
w
B
E
k
I
"}
(7,1,1) = {"
I
Q
Q
k
k
G
G
k
F
I
"}
